00000000000000000
01110111011101110
01000001010000010
01011101010111010
00010000000001000
01010111011101010
01000100000100010
01110101110101110
00000000010000000
01110111010101110
01-1-1-1001000100010
01-1-1-1101011101010
00-1-1-1100000001000
01011101010111010
01000001010000010
01110111011101110
00000000000000000